R 800 600
           NO       textures/north.xpm
SO textures/south.xpm
WE textures/west.xpm
EA  textures/east.xpm
 S         textures/stripe.xpm
    C  255,200,160        
    F  122,122,122


		1111111111111111111111111
		1000E00000110000000000001
		1011000011110000020000001
		1001000020000000020000001
111111111111000001100200000000001
100000000011000001101111111111111
11110111111111011100000010001
11110111111111011101010010001
11000000110101011100000010001
10000000200000001100020010201
10000000000200001101210000001
1100000111010101111101111000111
11110111 1110101 101111012001
11111111 1111111 111111111111