R 500 500
NO textures/north.xpm


SO textures/south.xpm
WE textures/west.xpm
EA textures/tete.xpm
S textures/stripe.xpm



F 135, 230, 152
C 135, 230, 152




1111111111
1000000001
1000000001
100000N001
1000110101
1000112111
1000011101
1111111111