
NO textures/north.xpm


SO textures/south.xpm
WE textures/west.xpm
EA textures/east.xpm
S textures/stripe.xpm
SR textures/stripe.xpm

F 222,252,111
C 0,0,0
1111111111
10000000E1
1000000001
1000000001
1000110101
1000112111
1000011101
1111111111